{
  "maze": [
    "--------------------------------------------------",
    "--------------------------------------------------",
    "--------------------------------------------------",
    "------------------------------------------XX------",
    "--------------------XXX-------------------XX------",
    "------XXX-----------XXX---------------------------",
    "------XXX-----------XXX---------------------------",
    "------XXX-----------------------------------------",
    "--------------------------------------------------",
    "-------------------------------------XX-----------",
    "-------------------------------------XX-----------",
    "--------------------------------------------------",
    "--------XXX---------------------------------------",
    "--------XXX---------------------------------------",
    "--------XXX---------------------------------------",
    "----------------------------XXXX------------------",
    "----------------------------XXXX------------------",
    "----------------------------XXXX------------------",
    "----------------------------XXXX------------------",
    "--------------------------------------------------",
    "----------------XX--------------------------------",
    "----------------XX--------------------------------",
    "--------------------------------------------------",
    "------XXX-----------------------------XXX---------",
    "------XXX-----------------------------XXX---------",
    "------XXX-----------------------------XXX---------",
    "--------------------------------------------------",
    "------------------------XX------------------------",
    "------------------------XX------------------------",
    "--------------------------------------------------",
    "--------XX---------------------------XX-----------",
    "--------XX---------------------------XX-----------",
    "--------------------------------------------------",
    "--------------------------------------------------",
    "--------------------------------------------------",
    "--------------------------------------------------",
    "----------------XXX------------XXXX---------------",
    "----------------XXX------------XXXX---------------",
    "-----XXX--------XXX------------XXXX---------------",
    "-----XXX-----------------------XXXX---------------",
    "-----XXX------------------------------------------",
    "--------------------------------------------------",
    "--------------------------------------------------",
    "---------------------------------------XX---------",
    "--------------------SSSSSSSSSS---------XX---------",
    "--------------------SSSSSSSSSS--------------------",
    "--------------------SSSSSSSSSS--------------------",
    "--------------------SSSSSSSSSS--------------------",
    "--------------------SSSSSSSSSS--------------------",
    "--------------------SSSSSSSSSS--------------------"
    ]
}