{
  "maze": [
    "--------------------------------------------------",
    "--------------------------------------------------",
    "--------------------------------------------------",
    "--------------------------------------------------",
    "--------------------------------------------------",
    "------XXX------------------XXX--------------------",
    "------XXX------------------XXX--------------------",
    "------XXX-----------------------------------------",
    "--------------------------------------------------",
    "-------------------------------------XX-----------",
    "-------------------------------------XX-----------",
    "--------------------------------------------------",
    "--------XXX---------------------------------------",
    "--------XXX---------------------------------------",
    "--------------------------------------------------",
    "----------------------------XXXX------------------",
    "----------------------------XXXX------------------",
    "----------------------------XXXX------------------",
    "--------------------------------------------------",
    "--------------------------------------------------",
    "----------------XX--------------------------------",
    "----------------XX--------------------------------",
    "--------------------------------------------------",
    "------XXX-----------------------------XXX---------",
    "------XXX-----------------------------XXX---------",
    "------XXX-----------------------------XXX---------",
    "--------------------------------------------------",
    "------------------------XX------------------------",
    "------------------------XX------------------------",
    "--------------------------------------------------",
    "--------XX---------------------------XX-----------",
    "--------XX---------------------------XX-----------",
    "--------------------------------------------------",
    "--------------------------------------------------",
    "--------------------------------------------------",
    "--------------------------------------------------",
    "----------------XXX-------------------------------",
    "----------------XXX---------------------XXX-------",
    "-XX-------------XXX---------------------XXX-------",
    "-XX-------------------------------------XXX-------",
    "--------------------------------------------------",
    "--------------------------------------------------",
    "--------------------------------------------------",
    "---------------------------------------XX---------",
    "SSSSSSSSSSSSSSSSSSSSSSSSSSSSSS---------XX---------",
    "SSSSSSSSSSSSSSSSSSSSSSSSSSSSSSSSSSSSSSSSSSSSSSSSSS",
    "SSSSSSSSSSSSSSSSSSSSSSSSSSSSSSSSSSSSSSSSSSSSSSSSSS",
    "SSSSSSSSSSSSSSSSSSSSSSSSSSSSSSSSSSSSSSSSSSSSSSSSSS",
    "SSSSSSSSSSSSSSSSSSSSSSSSSSSSSSSSSSSSSSSSSSSSSSSSSS",
    "SSSSSSSSSSSSSSSSSSSSSSSSSSSSSSSSSSSSSSSSSSSSSSSSSS"
    ]
}