{
  "maze": [
    "--------------------------------------------------",
    "--------------------------------------------------",
    "--------------------------------------------------",
    "------------------------------------------XX------",
    "------X-----------------------------------XX------",
    "------XXXXXXXXXXXXXXXXXXXXXXXX--------------------",
    "-----------------------------X--------------------",
    "-----------------------------X--------------------",
    "-----------------------------X--------------------",
    "-----------------------------X--------------------",
    "--------------------------------------------------",
    "--------------------------------------------------",
    "----XXXXXXXX-------------------------X------------",
    "----X--------------------------------X------------",
    "----X--------------------------------X------------",
    "----X--------------------------------X------------",
    "----X--------------------------------X------------",
    "----X--------------------------------X------------",
    "----X-----------------XXXXXXXXXXXXXXXX------------",
    "----X---------------------------X-----------------",
    "----X---------------------------X-----------------",
    "----X---------------------------X-----------------",
    "----X---------------------------------------------",
    "----X---------------------------------------------",
    "----X---------------------------------------------",
    "----XXXXXXXXXXXX-----------------------XX---------",
    "---------------------------------------XX---------",
    "------------------------XX------------------------",
    "------------------------XX------------------------",
    "--------------------------------------------------",
    "--------------------------------------------------",
    "-------------XX-----------------------------------",
    "-------------XX----------------X------------------",
    "-------------------------------X------------------",
    "-------------------------------X------------------",
    "-------X-----------------------X------------------",
    "-------X--------XXX------------X------------------",
    "-------X--------XXX------------XXXXXX-------------",
    "-------X----------------------------X-------------",
    "---XXXXX----------------------------X-------------",
    "---X--------------------------------X-------------",
    "---X--------------------------------X-------------",
    "---X--------------------------------X-------------",
    "---X--------------------------------X-------------",
    "--------------------SSSSSSSSSS--------------------",
    "--------------------SSSSSSSSSS--------------------",
    "--------------------SSSSSSSSSS--------------------",
    "--------------------SSSSSSSSSS--------------------",
    "--------------------SSSSSSSSSS--------------------",
    "--------------------SSSSSSSSSS--------------------"
    ]
}